XXXXXXXXXX
XH       X
X XX X X X
XDXX X X X
X XX X X X
X      X S
X XX X X X
X XX X X X
XEXX     X
XXXXXXXXXX