XXXXXXXXXX
XH    D  X
X XX X X X
XDXX X X X
X XX X X X
XD   D X S
XEXX X X X
X XX X X X
XEXXD   EX
XXXXXXXXXX
