XXXXXXXXXX
XH       X
X XX X X X
XDXX X X X
X XX X X X
X      X S
XEXX X X X
X XX X X X
XEXX    EX
XXXXXXXXXX
