XXXXXXXXXX
XH E  D  X
XEXX X X X
X XX X X X
X XX X X X
X     DX S
XEXX X X X
X XX X X X
XEXXD   EX
XXXXXXXXXX